R	900 1200
NO	textures/wood.xpm
SO	textures/purplestone.xpm
WE	textures/colorstone.xpm
EA	textures/moss.xpm

S	textures/tree.xpm
F	220,100,0
C	225,30,0

        1111111111111111111111111
        1000000000110000000000001
        1011000001110022200020001
        1001000000000000000020001
1111111110110000011100222N0020001
100000000011000001110111110111111
11110111111111011100000010001    
11110111111111011101010010001    
11000000110101011100000010001    
10000000000000001100000010001    
10000000000000001101010010001    
11000001110101011111011110001    
11110111 1110101 101111010001    
11111111 1111111 111111111111
