R	900 1200

NO textures/wall42-2-64x64.xpm
SO	textures/purplestone.xpm
	WE	textures/purplestone.xpm
EA	textures/wall42-2-64x64.xpm

S	textures/tree.xpm
F	220,100,0
C	225,30,0

        1111111111111111111111111  1111111111111
        1000000000110000000000001  1000100001001
        1011000001110022200020001  1111111111011
        1001000000000000000020001
1111111110110000011100222N0020001
100000000011000001110111110111111
11110111111111011100000010001    
111101111111110111010100100011   
110111110011010101110000001001    
1001   10000000011000000100011   
10011111000000001101010010001    
11000001110101011111011110001    
11110111 1110101 101111010001    
11111111 1111111 111111111111
