R	800	1200
NO	texture/brick.xpm
SO	texture/brick.xpm
WE	texture/colorstone.xpm
EA	texture/rock.xpm

S	texture/barrel.xpm
F	220,100,0
C	225,30,0

111111111111111
120000000000021
100300030003001
10000003N000001
100300030000001
100000000000001
120300000003021
111111111111111
