R	800	1200
NO	texture/brick.xpm
SO	texture/brick.xpm
WE	texture/colorstone.xpm
EA	texture/rock.xpm

S	texture/barrel.xpm
F	220,100,0
C	225,30,0

111111111111111
120000000000021
100000330000001
10030033N000001
100300330000001
100000330000001
120000000000021
111111111111111
