R	800	1200
NO	texture/brick.xpm
SO	texture/brick.xpm
WE	texture/colorstone.xpm
EA	texture/rock.xpm

S	texture/barrel.xpm
F	220,100,0
C	225,30,0

        1111111111111111111111111
        1000000000110000000000001
        1011000001110000000000001
        1001000000000000000000001
111111111011000001110000000000001
100000000011000001110111110111111
11110111111111011100000010001    
11110111111111011101010010001    
11333333110101011100000010001    
10000000000000001100000010001    
10300000000000001101010010001    
11000001110101011111011110001    
1111N111 1110101 101111010001    
11111111 1111111 111111111111
