R	8000	12000
NO	textures/brick.xpm
SO	textures/brick.xpm
WE	textures/colorstone.xpm
EA	textures/rock.xpm

S	textures/barrel.xpm
S	textures/tree.xpm
F	220,100,0
C	225,30,0

111111111111111
120000000000021
100000200000001
10020000N000001
100200000000001
100000000000001
120000000000021
111111111111111
