R	800	1200
NO	textures/wall1-64x64.xpm
SO	textures/wall5-64x64.xpm
WE	textures/wall2-64x64.xpm
EA	textures/wall3-64x64.xpm

S	textures/tree.xpm
S	textures/Pikachu-64x64.xpm
S	textures/Octane-64x64.xpm
F	220,100,0
C	225,30,0

        1111111111111111111111111
        1000000000110000000000001
        1011022001110022200420001
        10210400000003000N0020001
111111111011003001110022200020001
120000000011000001110111110111111
11110111111111011100000010001    
11110111111111011121010010001    
11000040110101011102000010201    
10020000000000021100000010201    
10420222000000021101010010201    
11020001114101011111211110001    
11112111 1112121 101111010001    
11111111 1111111 111111111111
