R	800	1200
NO	textures/wall1-64x64.xpm
SO	textures/wall5-64x64.xpm
WE	textures/wall2-64x64.xpm
EA	textures/wall3-64x64.xpm

S	textures/Pikachu-64x64.xpm
S	textures/Octane-64x64.xpm
F	220,100,0
C	225,30,0

        1111111111111111111111111
        1000000000110000030300031
        1011002001110022200020001
        10010000000000000N0020001
111111111011003001110022200020001
100000000011000001110111110111111
11110111111111011100000010001    
11110111111111011101010010001    
11000000110101011100000010201    
10000000000000001100200010201    
10000000000000001101010010201    
11000001110101011111011110001    
11110111 1110101 101111010001    
11111111 1111111 111111111111
